10
...+...++g
.+...+..+.
.++++++.+.
.+......+.
.+.++++++.
.+......+.
.++++++.+.
.+......+.
i+.++++++.
..........
