10
........+g
+.+.+...+.
+.+.+...+.
..+..+..+.
.+++.+..+.
..+..+..+.
+.+.+...+.
..+..+..+.
i+++.++++.
..........
